wwwwwwwwwwwwwwwwwwwwwwwwwwwwwwwwwwwwwwwwwwwwwwww
w0000000000000000000000000000000000000000000000w
w0000000000000000000000000000000000000000000000w
w0000000000000000000000000000000000000000000000w
w0000000000000000000000000000000000000000000000w
w0000wwwww0000000000000000000000000000wwwww0000w
w0000w000000000000000000000000000000000000w0000w
w0000w000000000000000000000000000000000000w0000w
w0000w000000000000000000000000000000000000w0000w
w0000w000000000000000000000000000000000000w0000w
w0000000000000w000000000000000000w0000000000000w
w0000000000000w000000000000000000w0000000000000w
w0000000000000w000000000000000000w0000000000000w
w0000000000000w000000000000000000w0000000000000w
w0000000000000w000000000000000000w0000000000000w
w0000000000000w000000000000000000w0000000000000w
w0000000000000w000000000000000000w0000000000000w
w0000000000000w000000000000000000w0000000000000w
w0000000000000w000000000000000000w0000000000000w
w0000000000000w000000000000000000w0000000000000w
w0000000000000w000000000000000000w0000000000000w
w0000000000000w000000000000000000w0000000000000w
w0000w000000000000000000000000000000000000w0000w
w0000w000000000000000000000000000000000000w0000w
w0000w000000000000000000000000000000000000w0000w
w0000w000000000000000000000000000000000000w0000w
w0000wwwww0000000000000000000000000000wwwww0000w
w0000000000000000000000000000000000000000000000w
w0000000000000000000000000000000000000000000000w
w0000000000000000000000000000000000000000000000w
w0000000000000000000000000000000000000000000000w
wwwwwwwwwwwwwwwwwwwwwwwwwwwwwwwwwwwwwwwwwwwwwwww