wwwwwwwwwwwwwwwwwwwwwwwwwwwwwwwwwwwwwwwwwwwwwwww
wwwwwwwwwwwwwwwwwwwwwwwwwwwwwwwwwwwwwwwwwwwwwwww
ww00000000000000000000000000000000000000000000ww
ww00000000000000000000000000000000000000000000ww
ww00000000000000000000000000000000000000000000ww
ww000wwwww0000000000000000000000000000wwwww000ww
ww000w000000000000000000000000000000000000w000ww
ww000w000000000000000000000000000000000000w000ww
ww000w000000000000000000000000000000000000w000ww
ww000w000000000000000000000000000000000000w000ww
ww000000000000w000000000000000000w000000000000ww
ww000000000000w000000000000000000w000000000000ww
ww000000000000w000000000000000000w000000000000ww
ww000000000000w000000000000000000w000000000000ww
ww000000000000w000000000000000000w000000000000ww
ww000000000000w000000000000000000w000000000000ww
ww000000000000w000000000000000000w000000000000ww
ww000000000000w000000000000000000w000000000000ww
ww000000000000w000000000000000000w000000000000ww
ww000000000000w000000000000000000w000000000000ww
ww000000000000w000000000000000000w000000000000ww
ww000000000000w000000000000000000w000000000000ww
ww000w000000000000000000000000000000000000w000ww
ww000w000000000000000000000000000000000000w000ww
ww000w000000000000000000000000000000000000w000ww
ww000w000000000000000000000000000000000000w000ww
ww000wwwww0000000000000000000000000000wwwww000ww
ww00000000000000000000000000000000000000000000ww
ww00000000000000000000000000000000000000000000ww
ww00000000000000000000000000000000000000000000ww
wwwwwwwwwwwwwwwwwwwwwwwwwwwwwwwwwwwwwwwwwwwwwwww
wwwwwwwwwwwwwwwwwwwwwwwwwwwwwwwwwwwwwwwwwwwwwwww