wwwwwwwwwwwwwwwwwwwwwwwwwwwwwwwwwwwwwwwwwwwwwwww
wwwwwwwwwwwwwwwwwwwwwwwwwwwwwwwwwwwwwwwwwwwwwwww
ww00000000000000000000000000000000000000000000ww
ww00000000000000000000000000000000000000000000ww
ww00000000000000000000000000000000000000000000ww
ww000wwwwwww000www000wwwwww000www000wwwwwww000ww
ww000w000000000000000000000000000000000000w000ww
ww000w000000000000000000000000000000000000w000ww
ww000w000000000000000000000000000000000000w000ww
ww000w000www000www000wwwwww000www000www000w000ww
ww000w000w0000000000000000000000000000w000w000ww
ww000w000w0000000000000000000000000000w000w000ww
ww00000000000000000000000000000000000000000000ww
ww00000000000w000www000ww000www000w00000000000ww
ww00000000000w00000000000000000000w00000000000ww
ww000w000w000w00000000000000000000w000w000w000ww
ww000w000w000w00000000000000000000w000w000w000ww
ww00000000000w00000000000000000000w00000000000ww
ww00000000000w000www000ww000www000w00000000000ww
ww00000000000000000000000000000000000000000000ww
ww000w000w0000000000000000000000000000w000w000ww
ww000w000w0000000000000000000000000000w000w000ww
ww000w000www000www000wwwwww000www000www000w000ww
ww000w000000000000000000000000000000000000w000ww
ww000w000000000000000000000000000000000000w000ww
ww000w000000000000000000000000000000000000w000ww
ww000wwwwwww000www000wwwwww000www000wwwwwww000ww
ww00000000000000000000000000000000000000000000ww
ww00000000000000000000000000000000000000000000ww
ww00000000000000000000000000000000000000000000ww
wwwwwwwwwwwwwwwwwwwwwwwwwwwwwwwwwwwwwwwwwwwwwwww
wwwwwwwwwwwwwwwwwwwwwwwwwwwwwwwwwwwwwwwwwwwwwwww